#######
#     #
#   $@#
#.    #
#######